a2i	a2i
aat	aaai
abbreviated	abandonment
abi	abe
abl	abilities
ably	ables
abramowicz	abort
abscissa	abrupt
absolutely	absent
absorption	absorbed
abstraction	abstract
acad	abundances
accelerate	academy
accelerator	accelerating
acceptably	accept
acceptor	accepted
accessing	accessed
accompanied	accommodated
accomplishes	accomplish
account	accordance
accumulate	accounting
accumulation	accumulates
accurate	accuracies
ach	ace
achievement	achieve
acid	achieving
acknowledgement	acknowledge
acous	acknowledgment
acoustically	acoustic
acquiring	acquired
acta	acrobot
acting	acteristic
activate	activ
activation	activates
activity	actively
actually	actu
acyclic	acuity
adap	adaline
adaptable	adapta
adaption	adapted
adatron	adaptively
added	adclus
adding	adder
additionally	addition
addressable	additively
ade	addresses
adequately	adelson
adjacent	adiabatic
adjustable	adjoint
administration	adjusting
admit	admissible
adrian	adopted
advance	adv
advantageous	advances
advice	adversary
aer	advocated
aerospace	aero
affecting	affect
afforded	affine
afterward	africa
age	agation
agent	agencies
aggregated	agglomerative
aging	aggregation
agr	ago
agrees	agreed
ahd	aha
aic	ahmad
aij	aifnn
ain	aimed
airborne	aip
aixi	aisb
akin	akaike
alan	alamitos
albright	albeit
alcove	albus
alessandro	alert
alfred	alexander
algebraically	algebra
algorithmic	algorit
align	aliased
alike	aligning
allen	alkon
allocate	allinson
allocation	allocates
allowed	allow
almaden	ally
alpha	alon
alspector	alphanumeric
altered	alter
alternately	alterna
alternative	alternating
alto	alternatives
alvis	altos
amap	alzheimer
ambiguities	amax
amer	ambiguous
ames	american
amino	amin
amorphous	amit
amples	ampa
amplifier	amplification
amplitude	amplify
ana	amputation
analogies	analog
analogy	analogously
analyser	analyse
analyte	analysing
analyze	analytical
analyzing	analyzer
anatomical	anandan
ances	anatomy
anderson	ander
andrew	andreas
angeles	anention
angles	angiotensin
animation	angular
ann	anisotropic
anneal	annal
annu	annealing
anomalous	annular
ansatz	anonymous
antagonist	answered
antennal	antecedent
anti	anterior
antisymmetric	anticipated
anyboost	anton
aperture	anyway
apical	apg
apparatus	apobayesian
appealing	apparently
appendix	appeared
applica	apple
applied	applicable
appreciable	apply
approached	appro
appropriately	approaching
approximate	approxi
approximating	approximately
april	approximator
arbib	aration
arbor	arbitrary
arch	arc
architectural	archie
arcing	architectures
aren	area
argi	arf
argue	argmaxp
ariaboost	argues
arising	arise
arline	arizona
armstrong	arma
arose	arnold
arranged	arpa
arrhythmias	array
arrives	arrive
art1	arrow
arti	artery
articulation	articles
artifactual	articulatory
artmap	artificial
ascender	ary
ase	ascent
ask	asi
asogawa	asking
assad	asr
assembly	assembler
assessed	assertion
assign	assessment
assimilation	assigning
asso	assistance
associate	associ
associative	associating
assumed	assp
assumption	assuming
ast	assured
astronomy	asterisk
asymmetries	asymmetric
asymptotes	asymp
asynchronous	asymptotically
ated	ata
ati	athe
ative	ating
atlanta	atiya
atom	atlas
att	ator
attack	attached
attained	attain
attempting	attempt
attentional	attended
attias	attenuated
attracted	attrac
attractor	attraction
ature	attributed
audiovisual	aud
aug	auditory
augmenting	augmentation
australian	austin
autapse	austrian
autoassociation	autistic
autoencoder	autoassociator
automatic	automate
autonomous	automation
autoshaping	autoregressive
avail	aux
aver	ave
averaging	averaged
avlsi	avi
avoided	avoid
aware	awake
awl	awi
axi	axe
axon	axis
babak	axt
backbone	bachrach
background	backfitting
backpropagate	backpropa
backscatter	backpropagating
baddeley	backward
bagged	baep
bair	bahl
bakker	baker
balances	balance
ballard	baldi
baluja	balltree
bandwidth	bandit
barak	bank
barely	barbara
barlow	bark
barnes	barnard
barrel	baroque
barrow	barrier
barto	bart
baseband	basal
basic	bases
basis	basilar
bat	bass
bath	batches
bauer	battery
bayes	baxter
bbd	bayliss
bdcl	bbp
beam	bdgptk
beaverton	bearing
bed	becker
began	beer
behav	beginning
behaving	behaved
behaviour	behavioral
belgium	behrmann
bell	believe
belong	bellman
benchmark	ben
beneath	bend
bengio	benefit
bennett	benjamin
berg	benveniste
berkeley	berger
bernardo	bernander
bernoulli	bernd
berthold	berry
beta	bessel
bhalla	beymer
bias	bialek
bible	biases
bicycle	bic
bielefeld	bidirectional
bigg	bifurcation
biilthoff	biggest
bilinear	bilateral
bill	bilities
bimodal	billion
binaural	binary
bined	binder
binocularly	bingo
biol	bio
biology	biological
biophysic	biometrika
biped	biophysically
bird	bipole
bis	birmingham
bishop	bisection
bite	bistable
bivariate	bitmap
blackwell	black
blank	blake
ble	blasdel
blht	blend
blob	blindness
bloesch	blocked
blueprint	blowfly
blurred	blumer
boa	bmi
bochum	board
bohossian	bodies
bolic	bol
bonet	bond
boost	book
bootc	booster
border	bootstrapping
borne	borisyuk
boston	borst
bottleneck	botelho
bound	bottou
bounding	boundary
bow	bout
box	bowl
boy	boxlet
bpl	boyen
bptt	bpp
bradford	bra
brain	bradtke
branch	brainstem
brandeis	branching
braun	brasher
breast	breakdown
brendan	bregman
bridle	brian
bright	briegel
bring	brightest
brnn	british
broadening	broadband
brodley	broadly
brook	broken
brown	brosch
bruce	brownlow
brunelli	brunak
brute	brunswick
bucket	bss
budget	buckland
buffering	buffer
building	buhot
bull	bulb
bump	bullock
bundle	bumptree
burgard	burden
burl	burgess
burst	burnod
buses	burt
busy	bush
buy	butler
bytes	bypass
ca3	ca1
cached	cacciatore
cal	cai
calculate	calcium
calculation	calculates
calibrating	calibrate
call	calif
calling	called
cambridge	caltech
camp	cameras
canadian	campus
canceling	canberra
cancer	cancelled
cantly	candidates
capability	capa
capacitances	capac
capacity	capacitive
capture	caption
car	captures
carded	carbachol
cardinality	cardiac
carefully	care
carlo	carl
carolina	carnegie
carrier	carr
carrying	carroll
cartoon	carter
cascade	carver
casdagli	cascading
cash	cases
cat	cast
cate	catastrophic
categories	cated
category	categorize
caught	cauchy
caused	causal
cauwenbergh	caution
cb2	caveat
cca	cbm
ccr	ccg
cease	cdf
cedure	cedar
cell	ceil
censoring	cem
centering	center
centrally	central
centroid	centred
cepstrum	cepstra
ceptron	ception
cerebellum	cercal
cervical	certainly
cesses	cesa
cfl	cessing
cgm2	cgd
challenge	chaining
challenging	challenger
champion	chamber
chang	chance
channel	changed
chapelle	chaotic
charac	chapter
characterization	characterised
characterizing	characterized
charging	charged
chase	charlier
chauvin	chau
cheating	cheaper
checker	check
chellappa	checksum
chemotaxis	chemistry
cherkauer	cheng
chewing	chervonenkis
chick	chiang
children	chien
chip	chines
chiueh	chirp
choi	chmm
cholinergic	choices
choosing	choose
chorale	chopper
chosen	chord
chris	choukri
christoph	christian
chu	chromatic
chuck	chuang
chunker	chung
cia	churcher
ciative	cially
cient	cid
cio	cii
circuit	circle
circumstances	circular
cision	circumvented
city	cited
cknn	cjch
claimed	claiborne
clarendon	clamped
clark	clarify
class2	clas
classical	classi
classified	classifica
classifying	classifies
clayton	clauses
cleaning	clean
clearly	clear
click	cleveland
climbing	cliff
clipped	clinical
cln	clique
clockwise	clocked
closed	clos
closes	closeness
cloud	closing
clues	clude
clustered	clus
cluttered	clusteron
cmm	cm2
cnl	cmu
coarse	cnr
coastal	coarser
cochlear	cochlea
coda	cocktail
coder	codebook
coecient	codeword
coelho	coeffi
coexistence	coetzee
cognitive	coggin
coherently	coherence
coin	cohort
coincident	coincidence
cold	coisr
colinear	coleman
collapses	collapse
collect	collateral
collective	collecting
collicular	collector
collision	collin
coloring	colorado
columbus	coltheart
combi	columnar
combinatoric	combination
combines	combined
comfort	comer
command	coml
commissural	comment
committee	commitment
commu	common
communicated	communica
community	communication
compactly	comp
company	companies
comparatively	comparable
compares	compare
compartmental	comparison
compe	compatibility
compensates	compensate
compete	compensation
competition	competi
compiler	competitor
complete	complement
completes	completely
complexes	completion
compliant	complexity
complication	complicated
componentwise	component
composing	composed
compositionality	composition
comprehensive	comprehensibility
compression	compressed
comprising	comprised
computa	compu
computationally	computation
computes	computed
concatenating	con
conceivably	concave
concentrated	concen
concentric	concentrating
concern	conceptual
concise	concerning
concludes	conclude
concrete	conclusion
condensed	concurrently
conditionally	condition
conduct	conditioning
conducting	conductances
conf	cone
confidence	conference
configural	confident
confined	configured
confirming	confirmation
conformation	conflicting
confuse	confronted
congress	confusion
conjecture	conic
conjunctive	conjunct
connected	connecfionist
connectionist	connection
conquer	connolly
conse	conscious
consequence	consecutively
conservation	consequent
conserving	conserve
considerably	consider
consis	considered
consistent	consisted
consonant	consisting
constantinople	constancy
constitute	constellation
constrain	constitutes
construct	constraining
constructive	constructing
consummatory	consumer
contained	cont
context	contamination
contiguous	contextualized
contingent	contingencies
continuation	continu
continuing	continued
continuum	continuous
contraction	contract
contradictory	contradict
contrasted	contrary
contributes	contribute
controllable	contribution
conv	controller
conveniently	convenience
conver	conventional
convergent	converged
converse	converging
converted	conversion
convexity	converting
convolution	conveyed
convolving	convolve
cooking	cook
cooperate	cooling
coordi	cooperative
coordination	coordinated
copies	copenhagen
copy	coplanar
cording	cor
cornell	corinna
coronary	cornput
corporation	corpora
correct	corr
corrective	correcting
correlate	correctness
correlation	correlates
correspon	correlator
correspondences	corresponded
corrupted	corridor
corti	cortes
cos	cortices
cosmic	cosi
cotterill	costly
council	cou
counteract	counted
couple	counterpart
course	couples
covariance	courtesy
coverage	covariation
cow	covering
cpg	cox
crab	cpt
crawford	craig
cre	crbp
creasing	creased
creating	created
credibility	creature
crew	cressie
crick	crg
cristianini	crippa
crites	criteria
criticism	critical
cross	crl
crossing	crossed
crucial	crosstalk
crustacean	crude
csi	crystal
ct2	csrf
ctm	cti
cued	cubic
culture	cues
cumulative	cumming
curl	cup
curse	current
curvatures	cursor
cusp	curved
customer	custom
cutting	cut
cyb	cvpr
cybernetic	cyber
cycling	cycles
cynader	cylinder
daca76	daal03
daily	dagsvm
damaged	dam
dan	damped
daniel	danger
dark	dap
darp	darker
dasarathy	darrell
dat	dash
dataflow	database
dates	dataset
dave	datum
dawei	davies
db2	dax
dcp	dbt
deal	ddag
deangelis	dealt
dec	debate
decayed	decades
decentralized	december
decided	deci
decipher	deciding
declines	decisive
decoder	decode
decompose	decom
decomposition	decomposes
decorrelating	decorrelate
decoupling	decouple
decreasing	decreased
deduce	decremented
deeper	deemed
def	deeply
defense	defect
deficient	deficiencies
defines	define
deflection	definite
deg	deformation
degrade	degenerate
degrees	degrades
delaunay	dekker
delbriick	delayed
deletion	deleted
deliver	deliang
delusion	delivery
demanding	dem
demi	dementia
demonstrate	demodulation
demonstration	demonstrates
dence	demultiplexing
deneve	dendrites
denoising	denmark
denotes	denote
densities	dense
denver	dent
departure	depart
dependence	depend
dependent	dependencies
depicting	depict
depolarized	depletion
dept	depression
deriva	der
derive	derivative
derlying	derives
descendant	des
describe	descending
description	describing
designate	descriptor
designing	designed
desired	desirable
desynchronization	destination
detailed	det
detected	detect
deter	detection
determin	deteriorates
determined	determination
deterministically	determining
devel	deutsche
development	developed
deviates	deviance
devil	device
devoted	devised
deweese	devroye
dgement	dfg
diabolo	diabetes
diagnoses	diag
diagonalization	diagnostic
dialog	diagram
diameter	dialogues
dichotomies	diate
diction	dictated
died	didn
dif	dient
differen	differ
differentiable	differences
differentiated	differentially
differenttable	differentiation
difficulty	difficult
diffusive	diffusible
digital	dig
dij	digitized
dim	dilemma
dimensionalities	dimension
diminishes	dimensionless
diophantine	dio
dirac	dip
direction	direct
directly	directionality
disabling	dis
disagreement	disadvantages
disappear	disambiguate
discard	disappeared
discharges	discarding
discontinuity	disconnected
discounting	discount
discovering	discover
discrete	discrepancies
discrim	discretize
discriminant	discrimina
discriminating	discriminated
discriminatory	discriminative
discusses	discuss
diseases	discussion
disjunction	disinhibition
disordered	disk
disparity	disparate
displacement	dispersive
disregard	displayed
dissimilarities	dissertation
dissipative	dissipated
distance	dist
distinction	distant
distinguish	distinctiveness
distinguishing	distinguished
distractor	distortion
distributed	distribu
distributional	distributing
dition	disturbances
divergence	div
diverging	divergent
divided	diversity
division	divides
dmax	diw
dnf	dmp
dodier	document
dog	doesn
dollar	doina
domany	dom
dominate	dominance
domination	dominates
donoho	donald
dopamine	doom
dorothy	dorffner
dotted	dose
doubly	doubled
douglass	doucet
downhill	dow
doya	downstream
dqh	dozen
dram	dragonfly
drastic	dramatically
drawing	draw
dreyfus	dream
drive	drift
driving	driver
dru	dropped
dsbn	drug
dtw	dsn
dubm	duality
duction	duced
duffy	due
dunmur	dummy
dur	duplicated
dures	durbin
dxi	dvc
dyi	dye
dynamical	dynam
ear	e13b
earning	earliest
easiest	ease
eat	east
ebl	ebd
ecc	eca
echo	ecg
eckhorn	echolocating
econometric	ecoc
edelman	economy
edgeworth	edge_x
edited	edinburgh
eduard	editor
edward	education
eee	eec
eet	eel
effected	effec
effector	effectively
efficacy	effi
efficiently	efficiency
egelhaaf	efron
ehrenfeucht	egocentric
eigenfaces	eigen
eigenvalue	eigenfunction
eighth	eigenvector
ekf	ein
elaboration	elaborate
elbow	elastic
electric	elec
electrode	electrically
electron	electroencephalogram
electrophysiology	electronically
elegan	electrosensory
elementary	element
eleven	elevation
elicit	elf
eliminated	eligibility
eling	eliminating
ellipsoid	ellipse
elongated	elliptical
emaih	elsevier
embedding	embed
embody	embodies
emerge	ement
emerges	emergence
emit	emg
emotion	emitter
emphasized	emphasis
empirically	emphasizing
empty	employed
emulator	emulates
enabling	enabled
enclosing	ences
encodes	encoded
encountered	encompasses
encourages	encouraged
ending	end
endpoint	endogenous
enforce	energies
enforcing	enforcement
engel	engage
engineering	engineer
english	england
enhancement	enhance
enlarge	enhancing
ensemble	ennis
ensured	ensuing
entail	ensuring
entering	enter
entity	entirely
entropic	entrainment
entry	entropies
environ	envelopes
eog	environmental
epenthesis	eor
episodes	ephrin
epsp	epoch
equ	eptesicus
equality	equal
equate	equalizer
equidistant	equation
equipment	equilibrium
equiva	equity
equivalently	equivalences
eral	era
erated	erally
erence	eration
eric	ergodic
erm	erlanson
err	ernst
erty	error
esp	escape
ess	especially
essence	essay
establish	essentially
establishment	establishes
estimated	estima
estimator	estimating
ethernet	etal
euclidean	etrain
eurich	euler
eval	european
evaluates	evaluate
evant	evaluation
eventual	evenly
evidenced	evi
evidently	evident
evolutionary	evoked
evolving	evolved
examination	exactly
examining	examined
exceeding	exceed
excessive	exception
excitability	excised
excite	excitation
exclude	excites
exclusively	excluding
executes	execute
exemplified	execution
exhaustively	exert
exist	exhibited
exogenous	existing
expanded	exp
expec	expansion
expected	expectancy
experi	expensive
experimen	experienced
experimentation	experimental
expertise	experimenting
explanation	explained
explo	explicit
exploiting	exploitation
explored	exploratory
expo	exploring
exponentiated	exponential
exposition	expose
express	exposures
expression	expresses
extendable	exten
extensive	extending
externally	extent
extract	extra
extractor	extracting
extrapolation	extrapersonal
extreme	extrema
extrinsic	extremes
ezist	eyes
fabricated	f49620
faced	fac
facilitated	facial
facilities	facilitating
factoffal	fact
factorim	factored
factorization	factorised
factory	factorized
fahlman	fading
failures	failed
faithfully	fairly
FALSE	falling
family	familiarity
fanty	fan
farima	farber
fashion	farmer
fat	faster
faulty	fatigue
favored	favorable
fayyad	favour
feasible	fea
feb	feature
federal	fect
feed	fedorov
feeding	feedfor
feigenbaum	feeling
felix	feldkamp
female	fellow
fer	femoral
feret	ference
ferred	ferra
fetz	ferster
ffi	feulner
fi2	fft
fibres	fiber
fictive	ficient
fie	fidelity
fifteenth	field
figtire	fig
fii	figuration
fil	fij
filled	files
filter	filling
fimction	filtered
finance	final
find	finch
fined	finding
finger	finer
finitely	finished
finnoff	finkel
fires	fire
fish	firm
fitted	fit
fix	fitzhugh
fixing	fixed
flake	fki
flannery	flank
flat	flash
fld	flavor
fleisher	fleet
flicker	flexible
flipped	flight
floor	fll
flow	florham
fluctuating	flowing
flux	fluid
fmli	flying
focus	foa
focussed	focuses
fogelman	foe
folded	fol
follower	folk
food	fom
foraging	foot
forcement	force
fore	forcing
foreground	forecast
forgeries	forest
fork	forget
formalize	formal
formant	formally
formedness	formation
formula	forming
formulated	formulas
forrest	formulation
forthcoming	forsyth
forward	fortunately
founda	foun
fourier	founded
fov	fourteenth
foveation	foveal
fpga	fox
fragment	fraction
framework	frames
franco	francis
franzini	franke
fre	fraser
freed	fred
freeman	freedom
french	freezing
frequent	frequencies
frey	fresh
friedman	fric
fritzke	friend
front	frog
fruit	frontier
ftp	fsa
fukumura	fujita
fulfill	fukushima
func	full
functionally	functional
fundamentally	fund
furnace	funding
fusion	fuse
g4f3	fuzziness
gabor	gabaergic
gained	gacv
gal	gaining
gallant	gallager
gam	gallinari
gammon	games
ganglia	gan
gardner	gap
gary	garrett
gat	gas
gates	gatech
gathering	gather
gauge	gation
gaussian	gauss
gbf	gave
gdalyahu	gcm
geiger	gdr
gelfand	gelatt
gen	geman
gener	gender
generalisation	generafive
generaliza	generalised
generalizes	generalize
generate	generally
generation	generates
generic	generative
genesis	generous
geniculate	genetically
gentner	genp
geoffrey	genuine
geometries	geometrical
georgetown	georg
gerald	georgopoulos
gershenfeld	german
gert	gerstein
gestures	gestalt
ghahramani	getting
giant	ghosh
gielen	gibbon
giles	gij
gilloux	gill
gion	gindi
gish	girosi
glance	give
gle	glass
globin	global
glove	glomeruli
glue	gluck
gmd	gly
gnu	gmm
going	god
goldfish	goldberg
goldstein	goldmann
golowich	goles
goodness	goodhill
gopalakrishnan	gop
goudreau	gorithm
governing	govern
gpp	gpc
gracefully	grace
gradi	grade
graduate	gradual
graham	graepel
gram	grained
gramming	grammatical
grant	grandmother
graphic	granule
grasped	graphically
gratefully	grass
graylevel	gravity
greater	graz
greedy	greatly
gregory	greenspan
grid	grey
grinvald	grill
grossly	gross
grounded	grot
grove	grouped
growth	growing
gsm	grupen
guage	gtm
guarantees	guaranteed
guessing	guess
guided	guidance
gull	guiding
gurewitz	gun
guyon	gustavo
h37	gyroscope
hadjifaradji	haar
hager	haft
hair	haifa
halfway	halbert
halt	hallucination
hamilton	halves
hammerstrom	hamiltonjan
han	hampshire
handbook	hancock
handle	handicap
handprint	handles
hansel	handwriting
happened	hanson
hard	haptic
harmful	hardness
harmonies	harmonet
harmony	harmonization
harry	harris
hash	hartman
hasselmo	hashing
hat	hastad
hawaii	haven
haykin	hayashi
header	hdnn
hear	health
heat	hearing
heavy	heavily
hecht	hebbian
heidelberg	heckman
helix	heiligenberg
helped	helmholtz
hemineglect	helping
hen	hemispheres
henkle	henderson
herbrich	henry
hermansky	hergert
hertz	hermitian
hetero	heskes
heuristic	heterogeneous
hibitory	hewlett
hierarchical	hidden
higgin	hierarchies
highlight	higher
hij	highly
hildreth	hilbert
hillsdale	hillclimbing
hinge	hinder
hinton	hinges
hirai	hippocampal
historical	hirsch
hitachi	history
hkw95	hitting
hme	hmc
hoc	hnear
hod	hochreiter
hofmann	hoeffding
hogg	hogan
hole	holden
holistic	holger
holloway	hollatz
holon	holmes
homogeneous	homing
hon	homology
hop	hong
hopefully	hope
hopping	hopfield
horizontal	horiuchi
hornik	horn
host	hospital
houk	hough
housing	hourly
hoyer	hover
hrr	hrault
htm	hss
hubbard	http
hue	huber
hughes	huffman
human	huji
hungry	humphrey
hurlbert	hunt
huxley	hush
hyper	hwang
hypercube	hyperbolic
hyperplane	hyperparameter
hyperpolarizing	hyperpolarization
hypersurface	hyperspectral
hypothesized	hypothesis
hyv	hysteresis
iai	i00
ibm	ian
icann	ical
icd	icassp
ickinger	iceg
iconic	icml
id2	icx
ideal	ida
iden	ideally
identifiable	identical
identify	identified
idm	identities
ieee	ied
ifa	ies
ifk	iff
ify	ifr
ignore	igi
ihl	ignoring
iii	iid
iiiiiii	iiiii
iil	iiiiiiiiiii
iio	iim
iiw	iir
ijcnn	iiz
ild	ikeda
illegal	ilk
illll	illinois
illus	illuminated
illustrated	illusory
illustrative	illustrating
ima	ilx
imaginary	imagery
imate	imaging
imb	imation
iment	imbert
imitation	imitate
imll	imize
immune	immature
impaired	impact
imperfect	impedance
implantable	imperfectly
implement	imple
implemented	implementable
implicit	implicated
imply	implied
important	impor
imposes	impose
impression	impossible
improve	imprinting
improving	improvement
imputation	impulses
inability	imum
inactivating	inaccuracy
inaij	inactive
incapable	inappropriate
incident	inch
included	includ
inclusive	including
incompatible	incom
inconsistent	inconsistencies
incorporates	incorporate
incorrectly	incorporation
increased	increas
increment	increasing
incrementing	incrementally
indebted	incurred
independence	indefinitely
index	independent
indi	indexes
indication	indiana
indirect	indicator
indiveri	indispensable
indoor	individual
induces	induced
industrial	induction
ined	industry
inefficient	inefficiencies
inertial	inequality
inexact	inevitable
infeasible	inf
inferences	infer
inferred	inferior
infinitely	infi
influence	infinity
influential	influences
infor	info
informal	inform
informational	informatik
infrared	informative
ingredient	infrequently
inherit	inherent
inhibited	inhibi
inhibitory	inhibition
init	ini
initialised	initialisation
initializes	initialize
initiated	initially
inject	initiation
injury	injecting
inn	inked
innervation	innervate
insect	input
insert	insensitive
inset	inserting
insignificant	insight
inst	inspiration
instance	instability
instantaneously	instant
institut	instantiation
instructed	institutes
instrumental	instructive
insures	insulin
integer	intact
integrand	integrable
integrating	integrated
intel	integrative
intelligent	intelli
intended	intemeuron
intensive	intensities
interac	intention
interactive	interacting
interchange	interaural
interconnectivity	interconnected
interestingly	interested
interfacing	interfaced
interior	interference
interna	interlocking
internet	internally
interpolant	interplay
interpolating	interpolated
interpretability	interpolator
interpreter	interpretation
interruption	interrelated
intersegmental	intersecting
intervening	interspike
intra	intimately
intractable	intracortical
intricate	intrapersonal
intro	intrinsic
introducing	introduced
intrusion	introductory
intuitively	intuition
invaluable	inv
invariant	invariance
inversely	inventory
invertebrate	inversion
invertible	inverted
investi	invest
investigating	investigated
investor	investigator
invoke	invisible
involved	invoking
io0	involves
iol	iohmm
ioo	ionic
ipsp	ipi
iri	ira
irradiance	iris
irregularities	irreducible
irrespective	irregularly
isard	isaac
ishii	isbell
isis	isih
ismail	island
isolated	iso
isomorphic	isomap
isr	ison
issues	isscc
italian	istic
item	itc
iterated	itera
iterative	iterating
iti	ith
itrule	itive
ivaldi	itti
iwi	ivi
iyi	ixi
jaakkola	ized
jackknife	jack
jacobian	jacob
james	jagota
janssen	jane
japanese	janus
jayakumar	jaw
jection	jebara
jelinek	jeff
jeremy	jensen
jerusalem	jerrum
jhu	jfet
jim	jiirgen
jmi	jio
jobshop	joachim
johnston	john
joining	join
jolliffe	jointly
jong	jonathan
joseph	jose
jpl	jour
judd	jth
judgement	judge
juggling	judgment
jumping	july
justification	june
justin	justifies
kaas	jyh
kaelbling	kabsch
kairiss	kai
kamimura	kam
kan	kammen
kanerva	kanazawa
kansas	kangas
kappa	kapadia
karmarkar	karhunen
katayama	karunanithi
kaufman	kauf
kay	kawamoto
kdd	kcl
keck	keam
keesing	keeler
kempter	kelly
kennedy	kendall
kepler	kent
kerr	kern
key	kerszberg
kfm	keyword
kij	kiang
kinases	kin
kinematic	kindermann
kinzel	king
kirkpatrick	kirillov
klab	kivinen
klopf	klein
knew	kmax
knn	knight
knowledge	knowing
koenderink	knudsen
kohn	koffka
koistinen	koike
kom	koller
konishi	kong
korn	korea
kotani	kosko
kramer	koza
kristan	kreutz
kruschke	kronecker
kth	kryukov
kullback	kuh
kupfermann	kung
kutta	kurtosis
kwta	kwok
label	kyoto
labeller	labeling
laboratories	labor
lacking	laborious
lagged	lafayette
laheld	lagrangian
lake	laid
lambert	lal
lamme	lamina
land	lan
landmark	landgrebe
landy	landscape
langevin	lang
lapedes	languages
lapses	laplacian
largely	larc
larry	largest
lasso	laser
lat	lasting
late	latched
latent	latencies
latest	lateral
laughlin	lattice
lavigne	lauritzen
layer	lawrence
lazzaro	layout
lda	lbg
leading	lead
leaky	leak
leap	leaming
learnable	learn
learnt	learner
leaving	leave
lection	leblanc
lecun	lecture
leemon	lee
leftmost	leerink
legend	leg
lehic	legion
leisch	lei
lemma	lem
len	lemmon
lent	length
leonard	leo
les	leopold
leslie	lesioned
letter	lesson
lev	letting
leveraged	levenberg
levin	leveraging
levy	levinson
lexicon	lewis
lgn	lfa
lib	lhe
lid	libraries
lifelong	liebler
ligand	lift
lightness	lighter
likelihood	lij
limb	likewise
limited	limit
linda	lin
linear	linder
linearize	linearity
lined	linearizing
linguistic	lines
linking	linkage
lip	linster
lippmann	lippe
liquid	lipschitz
lissom	lisberger
listening	listed
lit89	lit
littlestone	literature
live	littmann
lives	liver
lldn	ljung
llll	llin
llp	lln
lly	llx
lnq	lna
loading	load
lobes	lob
local	loc
localization	localist
localizing	localized
locates	locate
locator	location
locked	loci
locomotion	locking
loess	locus
logarithm	log2
logic	logarithmically
logit	logically
logo	loglog
lond	logp
longitudinal	longer
lookahead	loo
looo	looking
loosely	loopy
loses	lose
lost	loss
louis	loth
lowed	low
lowest	lowered
lpc	lowpass
lrta	lqr
lsf	lsb
lta	lstm
lucas	ltm
luenberger	lucia
luminanee	lui
lund	lumped
lus	luo
lvl	luttges
lvq2	lvnl
lwpl	lwpca
lying	lxt
lyon	lynch
mac	m5s
machine	macgregor
mackay	machines
macro	mackintosh
mae	mad
magellan	magazine
magnification	magnet
magnitudes	magnifying
mahalanobis	magnus
mail	mai
maintain	mainen
maiorov	maintaining
makeig	major
making	makes
malcolm	malach
males	male
malization	malignant
malpeli	malkoff
mammal	malvern
manageable	mammone
managing	management
manfred	mand
manifested	manifest
manipulated	manipulandum
manke	manipulation
mansour	manncon
manuscript	manually
mapping	map
marcel	marbach
marder	marchand
marginalizing	marginal
marina	margoliash
marked	marion
market	markel
markov	markman
markus	markovjan
marroquin	marquardt
martignon	marshall
marvin	martinetz
mas	mary
masked	masino
massachusett	mason
massively	masses
mat	massone
matches	match
mately	mate
math	material
mathematically	mathematic
mathis	matheus
matically	matic
mato	mation
matsuoka	matrices
mature	matthew
max	maunsell
maximal	maxi
maximising	maximisation
maximizer	maximize
maxm	maximizing
maybe	maxq
mazimum	maze
mccallum	mcallester
mcclure	mcclelland
mceliece	mcculloch
mckenna	mcgovern
mcmillan	mclachlan
mcreynold	mcnaughton
mdt	mdl
meador	mea
meaningless	meaning
measured	measurable
mech	measures
mechanism	mechanic
median	media
medical	mediated
meet	medin
meilijson	meg
mel	meir
melody	melodic
member	melvill
memo	membrane
memorize	memories
memoryless	memorizing
mensional	menlo
mented	mental
mer	mentioned
merge	mere
merical	merges
mesh	merz
messenger	message
metal	met
metcalfe	metaphor
methodologies	meth
metropolis	metric
mexico	meure
mfc	mezard
mfn	mfinchen
mhz	mgorithm
micchelli	mial
michigan	michalski
microelectronic	microcalcification
micropower	microphone
microstructure	microscopic
middle	mid
mif	midpoint
miinchen	miikkulainen
mil	mika
mill	miles
milllet	million
min	mimic
mind	minai
mines	mined
minima	mingolla
minimisation	minimally
minimising	minimised
minimizer	minimize
mining	minimizing
minneapolis	ministry
minus	minor
mip	minutemax
mirrored	miranker
misclassification	misadjustment
misfiring	misery
mismatch	mislabeled
misses	miss
mistake	missing
mitchell	mistakes
mitsuo	mitral
mixture	mixed
mization	miyake
mizumori	mized
mlearn	mjolsness
mlz	mln
mmi	mm_vector
moc	mntn
modality	modal
modeling	model
moderate	modelling
modest	modern
modified	modifiable
modular	modify
modulates	modulate
modulatory	modulation
modulus	modules
mohawk	mog
mol	moidal
moller	molecule
mon	momenta
monday	monasson
monitored	money
mono	monk
monolithic	monocular
monotonic	monosynaptic
montague	monotonicity
monthly	montgomery
moon	mood
morasso	moore
morph	mori
morphologies	morphogenesis
mort	morris
mosaic	morton
moss	mosfet
motif	mostafa
motivates	motivate
motorola	motoneuron
mountcastle	moulin
move	mouse
moves	movellan
movshon	movies
mpfim	mozer
mrf	mrbf
mrtd	mrna
msec	msd
mstd	msse
mtse	mth
mukherjee	muenchen
multichannel	muller
multigrid	multicollinearity
multimodal	multilayered
multiples	multinomial
multiplication	multiplexer
multiplier	multiplicity
multiprocessor	multiply
multistage	multiscale
multiuser	multitask
mum	multivariable
munich	mumford
muon	munos
murray	muroga
musculo	muscles
musical	mushroom
mutation	musk
myer	mutual
nabney	mzard
nadel	nadal
nakai	naive
nal	nakashima
namical	names
nanosecond	nance
narrow	nar
nary	narrower
nates	nasal
natl	national
naturally	natural
navigating	naval
navy	navigational
ne43	ncrg
nearly	nearby
necessitates	neces
nected	neck
need	nectionist
neg	needing
negatively	negation
neglected	negativity
neighbor	negligible
neighbourhood	neighboring
neil	neighbout
nen	nelson
neocortical	neocognitron
nerve	neously
net	ness
netic	netherland
netw	netr
neukirchen	netxvork
neural	neuneier
neuroanimator	neurm
neurochess	neurobiological
neurocontrol	neurocomputer
neuroinformatic	neurogammon
neuromimetic	neurological
neuromorphic	neuromodulator
neuronally	neuron
neurophysiol	neuronlike
neurosc	neurophysiology
neurosciences	neurosci
neutral	neurotransmitter
newsome	newly
ngnet	newton
nice	nical
nicol	nicholas
nih	niel
nil	nijmegen
ning	nilsson
niques	nip
nism	niranjan
nix	nit
nll	nized
nmos	nmda
nnd	nnbm
nnid	nnfa
noda	nnmber
nodes	node
noiseless	nohl
nolr	noising
noncausal	nominal
nonetheless	nondecreasing
nonlinear	nonincreasing
nonlocal	nonlinearity
nonnegative	nonmonotone
nonsingular	nonoverlapping
nonterminal	nonstationarity
nop	nonzero
normalisation	norm
normalization	normalising
normalizing	normalized
northwest	north
nosofsky	norwell
notational	notably
noteworthy	noted
noting	noticeable
nov	notoriously
npm	november
nrf	npv
nsm	nserc
nsw	nsr
nuclear	ntn
nuisance	nucleotides
nullspace	nullcline
numer	number
numerical	numerator
nxn	numerous
oak	nyu
obey	obd
objection	objec
obradovic	objectives
observability	obser
observational	observables
observes	observed
obtain	obstacle
obvious	obtained
occasional	occam
occluder	occipital
occupant	occlusion
occupy	occupied
occurred	occured
ocd	occurrences
oct	ockham
ocular	octaves
oculomotor	oculo
odh	odd
offer	oed
official	offering
ofleee	offline
ofw	oft
ogy	ogawa
ohmi	ohio
oij	ohzawa
older	oja
olive	olfactory
olivocerebellar	oliver
olson	olshausen
omitted	omission
onal	omlin
onoda	ongoing
ontario	onset
ooo	ooi
oped	oot
oper	opened
operated	operand
operational	operating
opment	opinion
opportunity	opponent
opposition	opposing
optical	opti
optima	optican
optimisation	optimality
optimistic	optimised
optimized	optimization
optimum	optimizes
orban	optional
ordering	order
ordinate	ordinal
organ	ore
organiza	organising
organizes	organize
orient	ori
oriented	orientation
original	orig
originates	originate
ormoneit	orlando
orsak	orponen
orthographic	orthogonal
oscil	ory
oscillating	oscillate
oscilloscope	oscillator
ossicles	osnn
otolith	oth
ouput	ottawa
outcomes	ously
outgoing	outer
outlines	outline
outperforming	outperform
outward	outseg
overcomes	ovarian
overestimates	overcomplete
overhead	overfitting
overlapping	overlap
oversampling	overly
overview	overt
owij	owen
oxford	owl
paa	oxide
pacific	pac
packages	pack
packing	packed
padhraic	pad
pain	pages
pairing	pair
palmer	pal
panel	pami
paper	pap
papoulis	paperr
parabolic	par
paral	paradox
parallelizable	parallel
parameter	paramagnetic
parameterized	parameterization
parametrization	parametrically
parberry	parasagittal
pareigis	pare
parga	parentheses
parisi	paring
parker	parity
parra	parmanto
parses	parsec
parthasarathy	parsing
partic	partial
particle	participate
partitioned	particu
party	partly
passage	pasadena
passes	passed
past	passive
patchy	patch
pathological	patent
patrick	patient
patterning	pattern
pauern	patti
pauses	paul
pay	pavlovian
pbf	payoff
pcc	pbr
pda	pcp
pdt	pdf
pearl	peaked
peculiar	pearson
peferences	pedestrian
penalization	pelillo
penalizing	penalized
pendence	penalty
peng	pending
pentium	pennsylvania
peper	penultimate
perceives	perceive
percentages	percent
perceptron	percept
pereira	perceptual
perfectly	perf
performances	perform
perfusion	performer
periment	perhap
periodically	period
periplaneta	peripheral
permission	permanently
permutation	permitted
perplexity	perona
persistent	persist
perspec	personal
pertain	perspectives
pertur	pertinent
perturbed	perturbation
pes	pervasive
peter	petajan
petsche	peterson
pfm	pfc
phase	phantom
phd	phases
phenomenon	phenomena
philadelphia	phi
philosophy	phillip
phone	phnm
phoneroes	phonemes
phonology	phonetic
photograph	photocell
photorefractive	photon
phrases	php
physical	physic
physik	physician
physiology	physiological
picked	pick
pictures	pickles
piecewise	piece
pii	pieraccini
pin	pilot
pinkas	pines
pioneered	pinna
piriform	pipelines
pitches	pit
pitt	pitfall
place	pittsburgh
plagued	places
plan	plain
planes	planck
plant	planner
plate	plastic
platform	plateaus
plaut	plausibility
playing	played
plefka	pleasure
plete	plenum
plexity	plex
plot	plied
plr	plotting
ply	plugging
pml	pm2
poggio	pneumonia
pointing	pointed
polak	poisson
pole	polarities
policy	police
polygonal	pollard
polynomially	polyno
pon	pomdp
pooled	poo
poorly	poor
popular	popu
port	population
portfolio	portant
pos	portland
posi	posed
positioned	position
positives	positive
possesses	posner
possibility	possi
postdoctoral	post
posteriori	poster
postsubiculum	postprocessing
posture	postulate
potential	potassium
potsson	potentiation
pouliquen	potter
ppl	power
practical	ppserver
practitioner	practice
pre	pratt
precedence	precede
precisely	preceding
precomputed	preclude
predator	precursor
predic	predefined
predictability	predicates
prediction	predicted
predominantly	predictor
preferable	prefactor
preferentially	preference
prehensile	prefix
premotor	preliminary
prepared	preoperative
preprocessed	preposition
prescribed	preprocessor
presentation	presence
preservation	presenting
preserving	preserved
press	presidential
presumably	pression
prevalent	presumption
previ	prevented
pri	previously
pricing	price
primary	primal
primed	primates
prin	primitive
principal	princeton
principled	principe
printing	print
prioritized	priori
pro	prism
proba	proaches
probabilistically	probabili
probe	probability
problematic	probing
procedures	proce
process	proceeded
processor	processes
produces	produce
prof	product
profiles	professor
prog	profitability
programmable	program
programming	programmed
progressive	progresses
prohibitively	prohibit
projecting	project
prominent	projective
promote	promises
prompted	promoting
pronunciation	pronounce
propaga	prop
propagating	propagated
properly	propel
proportion	property
proposal	proportionality
proposing	proposed
propulsion	propositional
protein	prospect
prototypes	protocol
proved	provably
provide	proven
proving	providence
proximation	proximal
prune	proximity
pse	pruning
psp	pseudo
psyche	psy
psychologically	psychol
psychophysical	psychophy
public	ptk
published	publicly
puff	publishing
pulse	pulled
pump	pulses
purdue	pupil
purpose	purely
pursuing	pursue
pushdown	pus
put	pushes
pute	putational
putting	puter
pyramid	pyloric
qian	qam
qlu	qij
qtrader	qmr
quadrature	quadratic
quality	qualitatively
quantifies	quanti
quantisation	quantifying
quantities	quantitative
quantized	quantization
quarter	quantizing
queen	quasi
quences	quek
queried	quency
ques	query
queueing	questionable
quickly	quick
quinlan	quiescent
quotient	quoted
rabiner	rabbit
radar	races
radian	radial
radio	radically
raffia	radius
rail	ragg
raining	rainer
raising	raised
rall	ral
ramanujam	ram
ran	ramnet
randomization	randall
rangacv	randomly
ranges	range
ranking	rank
raphson	rao
rare	rapidly
raster	rashid
rated	rat
ration	rating
rau	rationale
ray	raven
razor	raymond
rcc	rbm
rea	rcr
reaches	reachable
reaction	react
readable	reactor
ready	readily
realism	realisation
realization	reality
realizing	realized
reason	rear
reber	reasonably
recalled	rec
received	recce
recency	receives
reception	recently
recipe	receptor
reciprocally	recipient
recogni	recoding
recognize	recognition
recognizing	recognizer
recommendation	recombination
reconfigurable	recomputed
reconstructing	reconstruct
recording	record
recovery	recovered
rectangle	rect
rectified	rectangular
rectly	rectifying
recurrent	recur
recursive	recursion
red	recurslye
redlich	redish
reduces	reduce
redundancies	reduction
reed	redundant
ref	reestimate
referenced	refered
refine	referred
refining	refinement
reflecting	reflectance
reformulated	reflex
refresh	refractoriness
regard	reg
regeneration	regarding
region	regime
registration	register
regressor	regression
regularisation	regu
regularization	regularities
regularizing	regularized
regulates	regulate
regulatory	regulation
rehovot	rehearsal
reilly	reid
reinforced	reinf
rejected	reiterant
rel	rejection
relates	relate
relationship	relation
relaxed	relax
release	relay
relevance	releases
reliably	reliability
rely	relied
remainder	rem
remapping	remaining
remedy	remarkable
remote	remembered
removes	remove
render	ren
renormalization	rendering
rep	rent
repeated	repeat
repetition	repeating
replacement	replace
replicas	replacing
replicating	replicated
reported	replicator
repre	reposing
representable	represent
representatives	representational
reproduce	representing
reproduction	reproduces
require	request
requiring	requirement
resampled	res
rescheduling	rescaled
researcher	rescorla
resembles	resemble
resented	resent
resetting	reserved
residual	residence
resistance	residues
resistor	resistant
resolved	resolution
resonant	resolving
resource	resort
respect	resp
responding	respond
responsibility	responses
rest	responsive
resting	restarted
restrict	restore
restrictive	restricting
resulting	resultant
retaining	retain
retina	retical
retino	retinas
retinotopically	retinotectal
retraining	retrain
retrieving	retrieve
reusable	returned
reveal	reused
reversal	revealing
reversible	reversed
reviewing	review
revisited	revised
rewarded	revow
reza	rewriting
rgbn	rfwr
rhesus	rhbnc
rhythmic	rhodes
ric	rial
richardson	rich
richness	richly
ridges	rid
ries	rieke
rightward	rig
rigoll	rigidly
rij	rigorously
ring	rim
rion	ringnorm
risc	ripley
risk	rises
rithm	risto
rivalrous	ritzmann
rivest	rive
rli	rlc
rmse	rmhc
rnl	rni
road	rnsec
robertson	robbin
robotic	robinson
robustness	robustification
rock	rocchio
rodney	rockwell
roi	roger
roles	roitblat
rom	rolling
ronald	romma
root	ronny
rose	ror
rosenfeld	rosenberg
rota	rostral
rotating	rotated
roth	rotational
rounded	roughly
router	route
routines	routine
roweis	row
roychowdhury	roy
rrl	rprop
rsm	rrt
rti	rst
rubin	rtrl
rule	rudower
rulenet	rulebases
runaway	rumelhart
ruppin	running
ruth	russian
rvnl	rvm
s3vm	ryckebusch
saccade	sabes
sachusett	saccadic
saeed	sacrificing
saffman	safely
sahar	saha
sakai	saito
salamon	sakurai
saliency	salience
sam	salk
sampled	sammon
samuel	samples
sanger	sand
santosh	santa
sarnoff	sara
sasb	sarsa
satinder	satellite
satisfactory	satisfaction
satisfy	satisfied
saturate	sato
saturation	saturates
saund	sauer
saving	save
sayed	saxophone
scalability	sbsb
scaled	scalar
scan	scaling
scarce	scanned
scatterometer	scattered
scene	scenario
sch6lkopf	sch51kopf
sched	schaik
schedules	scheduled
schemas	scheeff
schemes	schematically
schizophrenia	schieve
schmidt	schmidbauer
schnitger	schneider
schottky	scholkopf
schreiner	schraudolph
schuster	schulten
schwenk	schwartz
sciences	sci
scofield	scientist
scores	score
scp	scotland
screening	scratch
sdf	script
sdti	sdm
searcher	search
seasonality	searching
secondary	sebastian
sector	section
seeger	sedal
seemingly	seek
sef	seen
segment	segev
segmented	segmental
segregated	segmenting
seismic	seibert
selec	sel
selection	selected
selectivity	selectively
sem	sell
semenov	semantically
seminal	semicircular
send	semiparametric
senior	sending
senses	sense
sensitivity	sensitive
sentation	sensorimotor
senting	sentence
separable	sepa
separates	separated
sepp	separation
sequence	september
sequential	sequences
serc	sequently
serially	serf
serrano	seriously
served	servation
services	serves
sesame	servo
setting	set
settling	settled
seventh	seung
sex	severely
sgd	sfi
shading	sgn
shadowing	shadmehr
shalom	shallice
shape	shamma
shapiro	shapes
shares	share
sharma	sharkawi
sharpening	sharpe
shashua	sharply
shattering	shatter
shear	shavlik
sheffield	shed
shepherd	sheng
shibata	shh
shifting	shifted
shimon	shikano
shock	ship
shortcut	short
shortest	shortening
shoulder	shortly
shrink	showing
shumeet	shrinking
shut	shun
sibility	siam
sickinger	sibling
sided	sid
sidorowich	sidered
sification	siegelmann
sig	siftcation
sigma	sight
signal	sigmoidal
signature	signaling
signifi	signed
signify	significant
sil	sii
silicon	silenced
silverman	sillito
simi	simard
similarly	similarities
simple	simon
simplicity	simplest
simplify	simplified
simsample	simplistic
simulate	simul
simulation	simulates
simultaneous	simulta
sinc	sin
singapore	sinewave
single	singh
singularity	singular
sinkhorn	sinh
sion	sinusoidal
sired	sionality
sistent	sis
sition	site
situation	situ
sively	siu
sixth	sixess
skagg	sized
skeletonisation	skeletal
sketched	skeletonization
skill	skewed
skip	skin
slab	skrzypek
slate	slaney
slices	sleep
slightly	sliding
slo	slit
slot	slope
slowest	slowed
small	slowly
smc	smallest
smeared	smdp
smith	smem
smooth	smola
smoothly	smoother
snakes	smyth
sniff	snapp
snow	snippet
sobolev	snr
society	social
sofge	soderberg
softky	soft
sojourn	software
solely	solar
solodov	solla
solv	solu
solver	solve
soma	solving
sommer	somatosensory
sondhi	son
sonn	song
soon	sontag
sor	sophisticated
sorting	sort
soulie	sought
sources	sour
southern	south
spacecraft	spa
span	spaces
sparcstation	spanning
sparse	spark
sparsity	sparseness
spatio	spatial
speak	spca
specht	speaking
specialize	specialist
specifi	specially
specificity	specifically
spectively	specimen
spectrally	spectra
spectrum	spectrogram
speechreading	speculate
spell	speeding
spend	spelling
sperling	spent
spheres	sphere
sphinx	spherically
spiegelhalter	spie
spin	spikes
spiral	spines
splice	spite
splitting	splines
sponse	spond
spontaneously	sponsored
spotting	spotlight
spring	spread
square	sprite
squashing	squares
srm	sri
ssom	ssa
stability	st2
stabilizes	stabilize
stack	stable
stage	stacking
stan	staggered
standardized	stand
stant	standpoint
start	star
stated	starting
stating	states
statis	stationarity
statistical	statisti
stb	status
steadily	stdev
steep	stearn
steerable	steepness
steinbuch	stefan
stemmler	stem
stephen	stent
stereo	stepsize
stern	stereopsis
stewart	steven
stim	stick
stimulating	stimulate
stinchcombe	stimuli
stochastically	stochas
stolorz	stock
stopped	stone
stored	storage
stork	stories
straight	story
strained	straightforward
strat	strand
strategies	strated
stray	stratum
strength	streaming
stress	strengthened
stretching	stretch
strike	strict
strip	string
stroke	striped
strongest	strong
structed	struc
structure	structural
stryker	structures
stud	stuart
studies	studentship
stvq	studying
sual	styles
subclasses	subband
subdomain	subdivided
subgoal	subfamily
subicular	subgraph
subjective	subject
submitted	sublinear
suboptimal	subnet
subregion	subpopulation
subsampling	subsample
subsection	subscript
subsequently	subsequences
substances	subspace
substituted	substantially
substrate	substituting
subsystem	substructures
subtract	subthreshold
subtree	subtracting
subvector	subunit
succeed	subworld
successes	succeeding
successive	successfully
suddenly	successor
suf	suematsu
suffi	suffered
sufficient	suffices
suggest	suffix
suggestive	suggesting
suitable	suit
sullivan	suite
sum	sulting
suming	sumed
summarized	summarised
summation	summarizing
summit	summer
sunspot	sun
superfluous	supercomputer
supernet	superior
supervised	superscript
supplement	supervisor
supply	supplied
supporting	support
suppressed	supposed
suppressive	suppressing
sured	sur
surfaces	surement
surprise	surgery
surrounded	surprisingly
survival	surveillance
susceptible	surviving
sustain	suspension
sutton	sut
svc	suzuki
swain	svm
swet	sweeping
swindale	swim
switch	swinging
switzerland	switches
syllable	sydney
symbolic	sym
symmetries	symmetrical
symplectic	symmetry
synap	symptom
synaptic	synapse
synchronization	synchro
synchronizing	synchronized
syndrome	synchronously
syntactic	synergy
synthesized	synthesis
syrinx	synthesizing
systematic	syst
table	szymanski
tachycardia	tablet
tag	tackled
tai	tagged
tain	tailed
takane	taining
tal	takeuchi
tally	talker
tance	tan
tangent	taneously
tank	tanh
tap	tanner
tar	tapered
targeting	target
tational	tat
tawel	taube
tca	taxi
teach	tdnn
tebelskis	teaching
technion	technical
technol	techniques
tection	technology
ted	tecture
teich	tee
telephone	telecom
teller	television
temperatures	temperated
tempo	template
temporary	temporally
tend	tempting
tenenbaum	tendency
tensor	tense
tential	tentative
tering	tered
term	terior
terminate	termed
termination	terminates
tern	terministic
terrence	ternational
tesauro	tertiary
testbed	test
tex	testing
textual	text
tha	textured
thalamus	thalamic
theme	thank
theorem	theonet
theoretische	theoretical
thereof	theory
thesis	thermodynamic
thickness	thi
thinking	thing
thirty	thiria
thompson	thodberg
thouless	thorpe
thresholded	thresh
thrown	throughput
tial	thrust
tical	tibshirani
tied	ticular
tiger	ties
tij	tighter
tiles	til
tilted	till
timation	timal
timestep	timescale
timothy	timit
tinit	tina
tion	tinuous
tionist	tionally
tipping	tip
tistical	tissue
titterington	tition
tives	tive
tlw	tle
tmg	tly
todorov	today
told	token
tom	tolerant
ton	tomita
tong	tone
tony	tonic
toot	tool
topo	topic
topological	topographically
tor	topologies
torques	toronto
torus	torrey
totally	tot
toulouse	touch
touretzky	touret
toy	tower
trace	tpf
track	traces
tract	tracker
trade	tractable
trading	tradeoff
trail	traditionally
trained	train
trajectory	trajec
transaction	tran
transduction	transcription
transferring	transfer
transformation	transform
transi	transformer
translate	transistor
translation	translates
transmission	translationally
transmitting	transmitted
transpose	transparent
trapping	trap
travel	trast
traverse	travelling
treasury	traverses
treatment	treated
tref	tree
trepan	tremendous
tri	treue
triangles	trial
tributed	triangulated
tried	trices
triggering	trigger
trim	trigram
triphones	trimming
trit	triples
trning	trivially
trophic	troller
trough	trouble
truly	truck
truncation	truncated
try	trust
tse	tsai
tsodyk	tsitsiklis
tst	tsp
ttk	tth
tucker	tual
tumor	tude
tuned	tunable
tuple	tunley
turbulence	turbation
turing	tured
turner	turn
tversky	tutor
twenty	twelfth
tying	twn
types	type
typist	typically
ual	u23
ucl	ubiquitous
ucsf	ucsc
uht	ues
ulated	uka
ull	ule
ultimately	ulm
ume	ulus
unacceptable	umontreal
unambiguously	unaltered
unbalanced	unavailable
unbounded	unbiasedness
unchanged	uncertainties
unconscious	unclear
uncorrupted	uncorrected
underdetermined	und
undergoing	undergo
underlying	underlies
undertaken	understanding
undirected	undesirable
unexplained	unequal
unfolded	unfaithful
uni	unfortunately
uniform	unification
unifying	uniformly
uninformed	unimportant
uniquely	union
united	unit
univer	univ
universe	universality
universitit	universit6
unknown	university
unlearning	unlabelled
unmixing	unlikely
unnikrishnan	unnecessarily
unobserved	uno
unpublished	unperturbed
unrelated	unrealizable
unrestricted	unrepresented
unseen	unscaled
unsolved	unsmearing
unsu	unstable
untrained	unsuitable
unvoiced	unused
uous	unweighted
updating	updated
upright	uphill
uran	upward
urinalysis	urbana
usable	urn
useless	usefully
usm	usg
usual	ussr
utgoff	utan
utilities	utilised
utilized	utilization
utterance	utilizing
v2s	uttered
val	vague
validated	valid
validity	validation
values	valuable
vanilla	vances
vanishingly	vanishes
vapnik	vap
variabilities	vari
variance	variable
variation	variant
varieties	varied
vas	vary
vat	vast
vcdim	vation
vector	vec
vehicles	vedelsby
veloso	velocity
ventral	venkatesh
verb	venus
verges	verge
verify	verification
verri	verlag
version	versatile
vertebrates	versus
vertices	vertical
vestibulo	vessel
vhere	veto
vice	viable
victorri	victimized
vides	vided
view	vidyasagar
viewpoint	viewer
vij	vii
vincentelli	village
violates	violate
virasoro	violation
virtually	vironment
viscosity	virtues
vision	visibility
visual	visited
visualized	visualization
visuomotor	visually
vittoz	viterbi
vlo	vladimir
vme	vlvp
vocabularies	vmos
vogl	vocal
voicing	voiced
volatility	vol
volt	volcanoes
volumes	voltages
voronoi	von
votes	vote
vovk	vou
vqpca	voyager
vsi	vrest
vtp	vsv
wafer	wada
wait	wahba
wako	wake
wall	walker
waltz	walter
want	wander
ware	war
warped	warmuth
warrick	warrant
wasted	washington
water	watanabe
watrous	waterloo
waugh	watt
wavelet	waveform
wc2r	wawrzynek
weakening	weaken
weaknesses	weakly
weather	wear
wechsler	webb
wei	wee
weight	weigh
weinshall	weighting
welch	weissman
werbos	welleken
west	wescon
weston	westervelt
wheel	wettschereck
white	whilst
whitening	whitelaw
wide	whittle
widespread	widening
wien	width
wii	wiesel
wiles	wik
willing	william
win	willsky
window	windfield
winner	wine
winther	winnow
wireless	wire
wisconsin	wiring
wishes	wish
wix	witbrock
wld	wji
wold	wlu
wolfgang	wolfe
won	wolpert
wood	wong
wordspotting	word
workshop	worker
worm	workstation
worthwhile	worst
wright	wpnn
written	writer
wta	wrong
wurtz	wtw
xerion	wyatt
xij	xie
xiy	xiw
xll	xld
xly	xlw
xt	xnor
xvith	xtx
yaleu	yair
yann	yamashita
yawelmani	yarom
yen	yee
yielded	yeung
yin	yif
yix	yishai
ylz	ylo
yoon	yokohama
yoshida	york
ysis	yoshua
yves	yuhas
zak	zag
zebra	zavaliagkos
zeger	zee
zeros	zero
zhao	zfe
ziehe	zhou
zimmermann	zigzag
zipset	zipcode
zlt	ziv
zone	zly
zornetzer	zoo
zur	zucker
zwislocki	zwi